00000000000000000000000000000000000000000000000000000000000000000000000000000000000000000000000000000000000000000000000000000000000000
00000000000000000000000000000000000000000000000000000000000000000000000000000000000000000000000000000000000000000000000000000000000000
00000000000000000000000000000000000000000000000000000000000000000000000000000000000000000000000000000000000000000000000000000000000000
00000000000000000000000000000000000000000000000000000222222222000000000000000000000000000000000000000000000000000000000000000000000000
00000000000000222222000000000000000000000000000000000000000000000000000000000000000000002220000000000000000000000000000000000000000000
00000000000000000000000022220000000000000002222222000000000000000002222222200000000000000000000022222222222200000000000000500000000000
00000000000000000000000000000000000000000000000000000000000000000000000000000000333330000000000000000000000000000000000005500000000000
00000002222000000000000000000000033333300000000000000000000000000000000000000000333530000000000000000000000000000000002222222000000000
00000002222000000000000000000000033443300000000000000000000000000000000000000000333530000000000000000000000000000000002222222000000000
00000002222000000000000000000000033333300000000000000000000000000000000000000000333330000000000000000000000000000000002222222000000000
11111111111111111111111111111111111111111111111111111111111111111111111111111111111111111111111111111111111111111111111111111111111111
11111111111111111111111111111111111111111111111111111111111111111111111111111111111111111111111111111111111111111111111111111111111111
11111111111111111111111111111111111111111111111111111111111111111111111111111111111111111111111111111111111111111111111111111111111111
11111111111111111111111111111111111111111111111111111111111111111111111111111111111111111111111111111111111111111111111111111111111111
