5000000000000000000000000000000000000000000000000000000000000000000000000000000000000000000000000000000000000000000000000000000000000005
5000000000000000000000000000000000000000000000000000000000000000000000000000000000000000000000000000000000000000000000000000000000000005
5000000000000000000000000000000000000000000000000000000000000000000000000000000000000000000000000000000000000000000000000000000000000005
5000000000000000000000000000000000000000000000000000002222222220000000000000000000000000000000000000000000000000000000000000000000000005
5000000000000002222220000000000000000000000000000000000000000000000000000000000000000000022200000000000000000000000000000000000000000005
5000000000000000000000000222200000000000000022222220000000000000000022222222000000000000000000000222222222222000000000000005000000000005
5000000000000000000000000000000000000000000000000000000000000000000000000000000003333300000000000000000000000000000000000055000000000005
5000000022220000000000000000000000333333000000000000000000000000000000000000000003335300000000000000000000000000000000022222220000000005
5000000022220000000000000000000000334433000000000000000000000000000000000000000003335300000000000000000000000000000000022222220000000005
5000000022220000000000000000000000333333000000000000000000000000000000000000000003333300000000000000000000000000000000022222220000000005
5111111111111111111111111111111111111111111111111111111111111111111111111111111111111111111111111111111111111111111111111111111111111115
5111111111111111111111111111111111111111111111111111111111111111111111111111111111111111111111111111111111111111111111111111111111111115
5111111111111111111111111111111111111111111111111111111111111111111111111111111111111111111111111111111111111111111111111111111111111115
5111111111111111111111111111111111111111111111111111111111111111111111111111111111111111111111111111111111111111111111111111111111111115
