00000000000000000000000000000000000000000000000000000000000000000000000000000000000000000000000000000000000000000000000000000000000000
00000000000000000000000000000000000000000000000000000000000000000000000000000000000000000000000000000000000000000000000000000000000000
00000000000000000000000000000000000000000000000000000000000000000000000000000000000000000000000000000000000000000000000000000000000000
00000000000000000000000000000000000000000000000000000000222222222222200000000000000000000000000000000000000000000000000000000000000000
00000000000000022222222220000000000000000000000000000000000000000000000000000000000000000000000000000000000000000000000000000000000000
00000000000000000000000000000000000000000000000000000000000000000000000000000000000000000000000000000000022222222222200000000000000000
00000000000000000000000000000000000000000000000000000000000000000000000000000000333330000000000000000000000000000000000000000000000000
00000000000000000000000000000000033333300000000000000000000000000000000000000000333430000000000000000000000000000000000000000000000000
00000000000000000000000000000000033443300000000000000000000000000000000000000000333430000000000000000000000000000000000000000000000000
00000000000000000000000000000000033443300000000000000000000000000000000000000000333330000000000000000000000000000000000000000000000000
11111111111111111111111111111111111111111111111111111111111111111111111111111111111111111111111111111111111111111111111111111111111111
11111111111111111111111111111111111111111111111111111111111111111111111111111111111111111111111111111111111111111111111111111111111111
11111111111111111111111111111111111111111111111111111111111111111111111111111111111111111111111111111111111111111111111111111111111111
11111111111111111111111111111111111111111111111111111111111111111111111111111111111111111111111111111111111111111111111111111111111111
